    WWWWWWWWWWWWWWWWWWWWWWWWWWWWWWWWWWWWWWWWW
    WWWWWWWWWWWWWWWWWWWWWWWWWWWWWWWWWWWWWWWWW
WWX      W              W       WWWWWWWWWWWWW
WW   H   W   WW                 WWWWWWWWWWWWW
WW  WWW  W    W                 WWWWWWWWWWWWW
WWWWW    WWWWWW         WWWWWWWWWWWWWWWWWWWWW
WW                              WWWWWWWWWWWWW
WW                   H          WWWWWWWWWWWWW
WWWWWWWWWWWWWWWWWWWWWWWWW       WWWWWWWWWWWWW
WW                      T       WWWWWWWWWWWWW
WW      WWWWWWWWWWWWWWWWW       WWWWWWWWWWWWW
WW      W                       WWWWWWWWWWWWW
WW      W                  H    WWWWWWWWWWWWW
WW      W                       WWWWWWWWWWWWW
WW      W           WWWWWW      WWWWWWWWWWWWW
WW      W           W    W      WWWWWWWWWWWWW
WW      W           W    W      WWWWWWWWWWWWW
WW      W           W    W      WWWWWWWWWWWWW
WW      W           W    W      WWWWWWWWWWWWW
WW      W           W    W      WWWWWWWWWWWWW
WW                  W           WWWWWWWWWWWWW
WW                  W           WWWWWWWWWWWWW
WW    W             W           EWWWWWWWWWWWW
WW    W     X       W           EWWWWWWWWWWWW
WWWWWWWWWWWWWWWWWWWWWWWWWWWWWWWWWWWWWWWWWWWWW
WWWWWWWWWWWWWWWWWWWWWWWWWWWWWWWWWWWWWWWWWWWWW