  WWWWWWWWWWWWWWWWWWWWWWWWWWWWWWWWWWWWWWWWWW
  WWWWWWWWWWWWWWWWWWWWWWWWWWWWWWWWWWWWWWWWWW
                                   W      WW
                                   W      WW
WWWWWWWWWWWWWWWWWWWWWWWWWWWWWW     W      WW
WW       X                   T     W      WW
WW       X                   T     W      WW
WW   WWWWWWWWWWWWWWWWWWWWWWWWW     W      WW
WW                                 W      WW
WW                                 W      WW
WW WWWWWWWWWWWWWWWWWWWWWWWWWWW     W      WW
WW                           W     W      WW
WW X                     T   W            WW
WW  WWWWWWWWWWWWWWWWW        W            WW
WW  W                        WWWWWWW      WW
WW  W                        WWWWWWW      WW
WW  W    WWWWWWWWWWWW                     WW
WW  W    W                                WW
WWWWW    WWWWWWWWWWWWWWWWWWWWWWWWWWW      WW
WW       X                                WW
WW       X                                WW
WWWWW    WWWWWWWWWWWWWWWWWWWWWWWWWWWWWWWWWWW
WW T                                       E
WW T                                       E
WWWWWWWWWWWWWWWWWWWWWWWWWWWWWWWWWWWWWWWWWWWW
WWWWWWWWWWWWWWWWWWWWWWWWWWWWWWWWWWWWWWWWWWWW