  WWWWWWWWWWWWWWWWWWWWWWWWWWWWWWWWWWWWWWWWWW
  WWWWWWWWWWWWWWWWWWWWWWTWWWWWWWWWWWWWWWWWWW
          H                               WW
                                          WW
WWWWWWWWWWWWWWWWWWWWWWWWWWWWWWWWWWWWWWW   WW
WW                                    W   WW
WW                                    W   WW
WW   X   WWWWWWWWWWWWWWWWWWWWWWWWW    W   WW
WW       T    H    X             W    W   WW
WW       WWWWWWWWWWWWWWWWWWWWW   W    W   WW
WW                               W    W   WW
WW                               WX   W   WW
WWXXWWWWWWTWWWWWWWWWWWWWWWWWWW   W    W   WW
WW                               W    W   WW
WW                               W    W   WW
WW   WWWWWWWWWWWWWWWWWWWWWWWWWWWWW    W   WW
WW   W                                W   WW
WW   W                                W   WW
WW   W   WWTWWWWWWWWWWWWWWWWWWWWWWWWWWW   WW
WW   W                                    WW
WW   W                                    WW
WW   WWWWWWWWWWWWWWWWWWWWWWWWWWWWWWWWWWWWTWW
WW                                         E
WW                                         E
WWWWWWWWWWWWWWWWWWWWWWWWWWWWWWWWWWWWWWWWWTWW
WWWWWWWWWWWWWWWWWWWWWWWWWWWWWWWWWWWWWWWWWWWW